**XXXXXXXXXXXXXXXXXX
X*****X***X*X*****XX
XXXXX*XXX*X*X*XXXXXX
X*X***X***********XX
X*X*XXXXX*XXXXXXXXXX
X*X*****X*******X*XX
X*X*XXX*XXX*XXX*X*XX
X*X***X*****X*X*X*XX
X*X*XXX*XXX*X*XXX*XX
X***X*****X*X*****XX
X*XXXXXXX*XXXXX*XXXX
X*****X*X*X*******XX
XXX*XXX*X*XXX*XXX*XX
X***X*********X*X*XX
XXXXX*XXX*X*XXX*XXXX
X***X***X*X*X*****XX
X*X*XXX*X*X*XXX*XXXX
X*X*****X*X*******XX
XXXXXXXXXXXXXXXXX***
XXXXXXXXXXXXXXXXXXX*
